NO ./pics/greystone.xpm
SO ./pics/bluestone.xpm
WE ./pics/mossy.xpm
EA ./pics/wood.xpm

C 0,0,55
F 255,0,0

     1      
11111011    
10000S001   
11111011    
1111101     
1111101     
1111101     
1111101     
1111101     
1111101     
1111101     
1111101     
1111101     
1111101     
1111101     
1111101     
1111101     
1111101     
1111101     
1111101     
1111101     
1111101     
1111101     
1111101     
1111101     
1111101     
1111101     
1111101     
1111101     
1111101     
1111101     
1111101     
1111101     
1111101     
1111101     
1111101     
1111101     
1111101     
1111101     
1111101     
1111101     
1111101     
1111101     
1111101     
1111101     
1111101     
1111101     
1111101     
1111101     
1111101     
1111101     
1111101     
1111101     
1111101     
1111101     
1111101     
1111101     
1111101     
1111101     
1111101     
1111101     
1111101     
1111101     
1111101     
1111101     
1111101     
1111101     
1111101     
1111101     
1111101     
1111101     
1111101     
1111101     
1111101     
1111101     
1111101     
1111101     
1111101     
1111101     
1111101     
1111101     
1111101     
1111101     
1111101     
1111101     
1111101     
1111101     
1111101     
1111101     
1111101     
1111101     
1111101     
1111101     
1111101     
1111101     
1111101     
1111101     
1111101     
1111101     
1111101     
1111101     
1111101     
1111101     
1111101     
1111101     
1111101     
1111101     
1111101     
1111101     
1111101     
1111101     
1111101     
1111101     
1111101     
1111101     
1111101     
1111101     
1111101     
1111101     
1111101     
1111101     
1111101     
1111101     
1111101     
1111101     
1111101     
1111101     
1111101     
1111101     
1111101     
1111101     
1111101     
1111101     
1111101     
1111101     
1111101     
1111101     
1111101     
1111101     
1111101     
1111101     
1111101     
1111101     
1111101     
1111101     
1111101     
1111101     
1111101     
1111101     
1111101     
1111101     
1111101     
1111101     
1111101     
1111101     
1111101     
1111101     
1111101     
1111101     
1111101     
1111101     
1111101     
1111101     
1111101     
1111101     
1111101     
1111101     
1111101     
1111101     
1111101     
1111101     
1111101     
1111101     
1111101     
1111101     
1111101     
1111101     
1111101     
1111101     
1111101     
1111101     
1111101     
1111101     
1111101     
1111101     
1111101     
1111101     
1111101     
1111101     
1111101     
1111101     
1111101     
1111101     
1111101     
1111101     
1111101     
1111101     
111111      
