
F     255,255,255    
C 255,255,255    

EA ./path_to_the_east_texture        
NO ./path_to_the_north_texture 
WE ./path_to_the_west_texture  


SO       ./path_to_the_south_texture        


  11111111
  10000001
  100000011111
  100000000001
  111110000001
      10000001
      10000001
      11111111
