
F     255,255,255    

EA ./path_to_the_east_texture        
NO ./path_to_the_north_texture 
WE ./path_to_the_west_texture  


SO       ./path_to_the_south_texture        

C 255,255,255    

       111
       101
       101
  111111011111
  1000000100S1
  100000011111
  100000000001
   11110000001
    1110000001
   10000000001
    111111111
